444444444444444444444444444
444444444444444444444444444
111111111111111111111111111
200000000000000000000000002
200000000003333300000000002
200000000003000300000000002
200000000003000300000000002
200000000003000300000000002
200000000003303300000000002
200000000000010000000000002
222222000000011111111111111
222222000000010000000000002
222222000000010000000000002
222222000000010000000000002
222222222222212222222222222
