222222222222222222222222222
200000000000000000000000002
200000000000000000000000002
200000000000000000000000002
200000000003333300000000002
200000000003000300000000002
200000000003000300000000002
200000000003000300000000002
200000000003303300000000002
200000000000010000000000002
200000000000011111111111111
200000000000010000000000002
200000000000010000000000002
200000000000010000000000002
222222222222212222222222222