444444444444444444444444444
444444444444444444444444444
111111111111111111111111111
200000333330000333333000002
200003333333003333333300002
200033333333333333333330002
200003333333333333333300002
200000333333333333333000002
200000033333333333330000002
200000003333333333300000002
100000000333333333000000002
200000000033333330000000002
200000000003333300000000002
200000000000333000000000002
222222222222232222222222222